WWWWWWWWWWWWWWWW
OBBBBBBBBBBBBVBW
OBBBBBBBBBBBBBBW
WBBWBBWBBWWWWBBW
WBBBBBBBBBBBBBBW
WBBBBBBBBBBBBBBT
WBBWWWWBBWBBWBBT
WBBVBBBBBBBBBBBW
WBBBBBBBBBBBBBBW
WWWWWWWWWWWWWWWW
