WWWWWWWWWWWWWWWW
TBBBBBBBBBBVBBBW
TBBBBBBBBBBBBBBW
WBBWBBWBBWWWWBBW
WBBBBBBBBBBBBBBW
OBBBBBBBBBBBBBBW
OBBWWWWBBWBBWBBW
WBBBVBBBBBBBBBBW
WBBBBBBBBBBBBBBW
WWWWWWWWWWWWWWWW
