WWWWWWWWWWWWWWWW
WBBBBBBBBBBBBBBO
TBBBBBBBBBBBBBBO
TBBWWWWBBWWWWBBW
WBBBWWBBBWWBBBBW
WBBBWWBBBWWBBBBW
WBBWWWWWWWWBBWWW
WBBBWWBBBVBBBBBW
WVBBWWBBBBBBBBBW
WWWWWWWWWWWWWWWW